.....#%#*.+..
.#.#.###...#.
.#.#.....+.#.
.#.#..#..+.#.
.#.#.+++++#..
.............
+.+++....##.+
.....###.....
.#.#.#.#.#.#.
.#.#.#.#.#.#.
.#.#.....#.#.
.#.#.###.#.#.
....@#$#.....