...+.%.+.....
.#.+.*.#.#.#.
.#....##.#+#.
...#.....+...
...#..+..#.#+
.....#..+....
.###...+...#.
...+.#...#.#.
+#.+.#.#...#.
.#.#.#.#.#.#.
.#.#.###.....
.#.......#.#.
...#@#$#.###.